#! The Inclusionist — nível "clarity"
#! Homenagem e crédito: mecânicas e layout de nível portados do projeto "Clarity",
#! de Adam Brooks (dissimulate), sob licença MIT.
#!   Código:  https://github.com/dissimulate/Clarity
#!   Jogável: https://codepen.io/dissimulate/pen/AGYEby
#! Legend dos glifos: app/js/core/tiles.js  (# pedra . ar : secreto ~ água H escada ^ trampolim x lava | portão * chave S/F/T/U/C power-ups)
#############
#...........#
#...........#
#...........#
#...........#
#...........#
#...........#
#...........#
#...........#
#...........#:::::::::::::::::#=====#
#...........#:::::::::::::::::#.....#
#...........#:::::::::::::::::#.....#
#...........#:::::::::::::::::#.....#
#...........#::::::::::::::::##.....###
#...........#::::::::::::::::#S.......#
#...........#::::::::::::::::####H###.#
#...........#:::::::::::::::::::#H#...#
#...........#:::::::::::::::::::#H#.###
#...........#:::::::::::::::::::#H#.#
#...........#:::::::::::::::::::#H#.#
#...........#:::::::::::::::::::#H#.#
#...........#:::::::::::::::::::#H#.#
#...........#:::::::::::::::::::#H#.#
#...........#:::::::::::::::::::#H#.#
#...........#:::::::::::::::::::#H#.#
#...........#:::::::::::::::::::#H#.#
#...........#:::::::::::::::::::#H#.#
#...........#:::::::::::::::::::#H#.#
###########.#####################H#.#
#.........#.#...................#H#.#
#.........#.#...................#H#.#############
#.#.......#.#...................#H#.########....#
#.##......#.#...................#H#.########....#
#.###.....#.#...................#H#.########....#
#.####......#....................H#.########F...#
#.#########=#..........##...#######.###########H#
#.###########.........###xxx#||||||.......*####H#
#....................########|#################H#
#...................#########.#################H#
#..................##########.#################H########
#=###########################.#################H#......#
#############################.#################H.......#
#.............................########################.#
#..#################===######=####.....................#
#..####.....................######.....................#
#..###...........................#..####################
#..##............................#..............#
#..#....................#####....#..............#
#........................####....#..............#
#.........................###....#^^#...........#
#..........................##....#####..........#
#...........................#....######.........#
#...........................#....#######........#
#...........................#....########.......#
#...........................#~~~~###########~~~~#
#...........................#~~~~###########~~~~#
#...........................#~~~~###########~~~~#
#...........................#~~~~###########~~~~#
#...........................#~~~~~~~~~~~~~~~~~~~#
#...........................#~~~~~~~~~~~~~~~~~~~#
#...................^^^.....#~~~~~~~~~~~~~~~~~~~#
#################################################
